#!/bin/bash


function blackrock_head() {
    echo '

__________.____       _____  _________  ____  __.__________._____________________   
\______   \    |     /  _  \ \_   ___ \|    |/ _|\______   \   \______   \______ \  
 |    |  _/    |    /  /_\  \/    \  \/|      <   |    |  _/   ||       _/|    |  \ 
 |    |   \    |___/    |    \     \___|    |  \  |    |   \   ||    |   \|    `   \
 |______  /_______ \____|__  /\______  /____|__ \ |______  /___||____|_  /_______  /
        \/        \/       \/        \/        \/        \/            \/        \/ 

'
}